ENSP00000302486
ENSAMEP00000003410
ENSBTAP00000045293
ENSCJAP00000013904
ENSCPOP00000002764
ENSDNOP00000012836
ENSDORP00000001219
ENSECAP00000008990
ENSFCAP00000020620
ENSFDAP00000006010
ENSSTOP00000008241
ENSLAFP00000005446
ENSMMUP00000048506
ENSMAUP00000010507
ENSMODP00000012146
ENSMUSP00000005066
ENSMLUP00000010740
ENSNGAP00000004997
ENSOANP00000015470
ENSOCUP00000007582
ENSOGAP00000014222
ENSPTRP00000063228
ENSPANP00000022054
ENSPPYP00000007458
ENSPVAP00000000060
ENSRNOP00000013933
ENSRROP00000020981
ENSSBOP00000012637
ENSSSCP00000056482
ENSTBEP00000012356
ENSTTRP00000009664
