ENSP00000382423
ENSAMEP00000003838
ENSBTAP00000018325
ENSCJAP00000003848
ENSCPOP00000013535
ENSDNOP00000014962
ENSDORP00000008507
ENSECAP00000005141
ENSEEUP00000005132
ENSFCAP00000013081
ENSFDAP00000010314
ENSSTOP00000006441
ENSLAFP00000000827
ENSMMUP00000034679
ENSMAUP00000005524
ENSMODP00000024354
ENSMUSP00000104890
ENSMLUP00000010663
ENSNGAP00000022189
ENSOANP00000021511
ENSOCUP00000007905
ENSOGAP00000002413
ENSPTRP00000048240
ENSPANP00000010741
ENSPPYP00000017294
ENSPVAP00000009165
ENSRNOP00000017968
ENSRROP00000024226
ENSSBOP00000017875
ENSSSCP00000017927
ENSTBEP00000011246
ENSTTRP00000010643
