 14 1203
ENSAMEG00000002212
AGCCTCGGACGGGCCTCCTCTGCGGAGNCGGCGCTCACTATCAACCCCGCCATCGCCGAGGGCCCGTCCCCCACCAGCGA
GGGCGCCTCCGAAGCAAACTTGGTGGACCTCCAAAAGAAGCTAGCGGAGCTAGAACTCGACGAGCAGCAGAAGAAGCGAC
TGGAAGCCTTCCTCACCCAGAAGGCCAAGGTTGGGGAGCTCAAGGACGATGACTTCGAACGGATCTCGGAGCTGGGAGCC
GGGAACGGCGGGGTGGTCACCAAGGTCCAGCACAGACCTTCCGGCCTCATCATGGCAAGAAAGCTGATCCACCTGGAAAT
CAAGCCGGCTATCCGGAACCAGATCATCCGCGAGCTGCAGGTGCTGCACGAGTGTAACTCGCCGTACATCGTGGGTTTCT
ACGGGGCCTTCTACAGCGACGGCGAGATCAGCATCTGCATGGAGCACATGGACGGCGGCTCTCTGGACCAGGTGTTGAAA
GAAGCCAAGAGAATTCCCGAGGAGATCCTGGGGAAGGTCAGCATTGCGGTTCTCCGGGGTTTGGCGTATCTCCGGGAAAA
GCACCAGATCATGCACCGAGATGTGAAACCTTCCAACATCCTCGTCAACTCCCGAGGGGAGATTAAGCTGTGCGATTTTG
GGGTGAGCGGACAGCTCATCGACTCCATGGCCAACTCCTTCGTGGGAACTCGGTCCTACATGTCTCCAGAGCGGTTGCAG
GGCACTCACTACTCTGTGCAGTCGGACATCTGGAGCATGGGCCTGTCCCTGGTGGAGCTGTCCATCGGAAGGTACCCCAT
CCCCCCGCCGGACGCCAAGGAGCTAGAGGCCATATTTGGCCGGCCCGTGGTGGACGGGGTAGAAGGAGAGCCTCACAGCA
TCTCACCACGGCCGAGACCCCCTGGACGCCCCATCAGCGGTCACGGGACGGACAGCCGGCCGGCCATGGCCATCTTCGAG
CTGCTGGACTATATCGTGAACGAGCCACCTCCCAAGCTGCCCAGTGGCGTCTTCACCCAGGACTTCCAGGAGTTTGTAAA
TAAATGCCTAATAAAGAACCCAGCAGAGCGAGCGGATCTGAAGATGCTCATGAGCCACACCTTCATCAAGCGGTCCGAGA
CGGAAGAAGTGGATTTTGCCGGCTGGTTGTGTAACACGCTGCGGCTGAACCAGCCCAGCACGCCCACGCGCGCTGCCGTG
TGA

ENSBTAG00000024450
ATGCTGGCCCGGAGGAAGCCGGTGCTGCCGGCGCTCACCATCAACCCCGCCATCGCCGAGGGCCCGTCCCCTACCAGCGA
GGGCGCCTCCGAAGCACATCTGGTGGACCTCCAGAAGAAGCTAGAGGAGCTAGAGCTCGACGAGCAGCAGAAGAAGCGGC
TGGAAGCCTTCCTTACCCAGAAGGCCAAGGTTGGTGAGCTCAAGGACGATGACTTTGAACGGATCTCCGAGCTGGGAGCC
GGCAATGGCGGAGTGGTCACCAAGGTCCAGCACAGACCTTCGGGCCTCATCATGGCCAGAAAGCTGATCCACCTGGAGAT
CAAGCCGGCCATCCGGAACCAGATCATCCGAGAGCTACAGGTGCTGCATGAGTGCAACTCCCCGTACATTGTGGGCTTCT
ACGGGGCCTTCTACAGCGACGGCGAGATCAGCATCTGCATGGAGCACATGGATGGCGGCTCCCTGGACCAGGTGTTGAAA
GAAGCCAAGAGAATCCCTGAAGAGATCCTGGGCAAGGTCAGCATTGCGGTTCTGCGGGGCCTGGCATACCTCCGGGAGAA
ACACCAGATCATGCACCGAGACGTGAAGCCGTCCAACATCCTGGTCAACTCCCGGGGGGAGATCAAGCTGTGTGACTTCG
GGGTGAGCGGCCAGCTCATCGACTCCATGGCCAACTCCTTCGTGGGGACGCGGTCCTACATGTCTCCGGAGCGGCTACAA
GGCACACACTACTCGGTGCAGTCAGACATCTGGAGCATGGGCCTGTCCCTGGTGGAACTGTCCATCGGCAGGTACCCCAT
CCCCCCGCCGGACGCCAAGGAGCTGGAGGCCATATTCGGCCGGCCCATGGTTGATGGCGCAGAAGGAGAACCTCCTAGCA
TCTCTCCACGGCCGAGGCCCCCTGGACGCCCCATCAGCGGTCACGGGATGGACAGCCGGCCTGCCATGGCGATCTTTGAG
CTGCTGGACTACATTGTGAACGAGCCTCCTCCCAAGCTGCCCAACGGTGTGTTCACCCAGGACTTCCAGGAGTTTGTAAA
TAAATGCCTAATTAAGAACCCAGCTGAGCGAGCAGACCTGAAGATGCTCATGAACCACACCTTCATCAAGCGGTCCGAGG
TGGAAGAAGTGGATTTTGCTGGCTGGTTGTGTAAAACACTGCGGCTAAACCAGCCCAGCACGCCCACACGCACCGCCGTG
TGA

ENSCPOG00000025428
ATGCTGGCCCGGAGGAAGCCGGTGCTGCCGGCGCTCACCATCAACCCCACCGTCGCCGAGGGCCCGTCCCCCACCAGCGA
GGGCGCCTCCGAGGCGAACCTGGCGGACCTGCAGAAGAAGCTGGAGGAGCTGGAACTAGATGAGCAGCAGAAGAAGCGGC
TCGAGGCCTTCCTCACCCAGAAGGCCAAGGTCGGCGAGCTCAAGGACGACGACTTTGAACGGATCTCAGAGCTGGGAGCC
GGCAATGGCGGCGTGGTCACCAAGGTCCAGCACAGACCGTCGGGCCTCATCATGGCCCGGAAGCTCATCCACCTGGAGAT
CAAGCCGGCCATCCGCAACCAGATCATCCGCGAGCTGCAGGTGCTGCACGAGTGCAACTCGCCCTACATCGTGGGCTTCT
ACGGGGCCTTCTACAGCGACGGCGAGATCAGCATCTGCATGGAGCACATGGACGGCGGCTCCCTGGACCAGGTGCTGAAG
GAGGCCAAGCGCATTCCTGAGGACATCCTGGGGAAAGTCAGCATCGCGGTGCTCCGGGGCCTGGCGTACCTCCGGGAGAA
ACACCAGATCATGCACCGAGACGTGAAGCCCTCCAACATCCTGGTCAACTCGAGAGGGGAGATCAAGCTGTGCGACTTCG
GGGTCAGCGGGCAGCTCATCGACTCCATGGCCAACTCCTTTGTGGGCACGCGGTCCTACATGTCTCCGGAGCGGCTGCAG
GGTACGCACTACTCGGTGCAGTCGGACATCTGGAGCATGGGGCTGTCCCTGGTGGAGCTGTCCATCGGCAGGTACCCCAT
CCCCCCACCTGATGCCAAGGAGCTGGAGGCCATCTTCGGCCAGCCTGTGCTGGACAGCCCGGAAGGGCAGCCCCAGAGCA
TCTCACCGCGGCCTCGGCCCCCCGGACGCCCCATCAGTGGTCATGGAGTGGACAGTCGGCCTGCCATGGCCATCTTCGAG
CTGCTAGACTACATTGTGAATGAGCCACCACCCAAGCTGCCCAGTGGTGTGTTCAGCCTGGACTTCCAGGAGTTTGTAAA
TAAATGCCTCATTAAGAACCCAGCAGAGCGTGCAGACCTGAAGATGCTCATGAACCACGCCTTCATCAAGCGCTCTGAGG
TGGAGGCCGTGGACTTCGCCGGCTGGCTCTGTAGGACCCTGCGGCTCCACCAGCCCGGCACCCCGACACGCAGCGCCGTG
TGA

ENSDNOG00000013548
ATGCTGGCCCGGAGGAAGCCGGTGCTGCCGGCGCTCACCATCAACCCCGCCATCGCCGAGGGCCCGTCCCCCACCAGCGA
GGGCGCCTCTGAGGCGAGCCTGGTGGACCTCCAGAAGAAGCTGGAGGAGCTCGAGCTCGACGAGCAGCAGAGGAAGCGGC
TGGAGGCCTTCCTCACCCAGAAGGCCAAGGTCGGCGAGCTCAAGGACGACGACTTCGAGAGGATCTCCGAGCTGGGCGCC
GGCAATGGCGGCGTGGTCACCAAAGTCCAGCACCGGCCCTCGGGCCTCATCATGGCCAGGAAGCTGATCCACCTGGAGAT
CAAGCCGGCCATCCGCAACCAGATCATCCGCGAGCTGCAGGTCCTGCACGAGTGCAACTCGCCCTACATCGTGGGCTTCT
ACGGCGCCTTCTACAGCGACGGCGAGATCAGCATCTGCATGGAGCACATGGACGGAGGCTCCCTGGACCAGGTGCTGAAG
GAAGCCAAGAGGATCCCCGAGGAGATCCTGGGCAAGGTCAGCATCGCGGTCCTCCGGGGCTTGGCGTACCTCCGGGAGAA
GCACCAGATCATGCACCGAGACGTGAAGCCTTCTAACATCCTGGTCAATTCCAGAGGCGAGATCAAGCTGTGCGACTTCG
GCGTGAGCGGGCAGCTCATCGACTCCATGGCCAACTCCTTCGTGGGAACCCGCTCCTACATGTCCCCGGAGCGGCTCCAG
GGCACCCACTACTCGGTGCAGTCGGACATCTGGAGCATGGGCCTGTCGCTGGTGGAGCTGTCCATCGGGAGGTACCCCAT
CCCCCCGCCCGACGCCAAGGAGCTCGAGGCCATCTTCGGGCGGCCCCTGGTCGACGGCGCCGAAGGAGAGCCCCCCAGCG
TCTCGCCGCGGCCACGGCCCCCCGGACGCCCCATCAGCGGGCACGGGGTGGACAGCAGGCCCGCCATGGCCATCTTCGAG
CTGCTGGACTACATCGTGAACGAGCCTCCGCCCAAGCTGCCCAGCGGGGTCTTCACCCAGGACTTCCAGGAGTTTGTAAA
TAAATGCCTGATCAAGAACCCCGCGGAGCGAGCCGACCTGAAGATGCTGATGGGCAGACCC------CAAAGAGCCCGTG
AGCTCCGCCCGGCAGCTCCCGGGGCCCTGTGTCTCCCAACTGGGGTCGCCCTA---CACACCCCACAAAGGTTTGGGGCT
CTA

ENSDORG00000001269
ATGCTGGCCCGGAGGAAGCCGGTGCTGCCGGCGCTCACCATCAACCCCACCATCGCCGAGGGCCCGTCCCCCACCAGCGA
GGGCGCCTCCGAGGCAAACCTAGTGGACCTGCAGAAGAAGCTGGAGGAACTGGAACTAGATGAGCAGCAGAAAAAGCGTC
TCGAGGCTTTCCTTACCCAGAAGGCCAAAGTCGGCGAGCTCAAGGATGATGACTTTGAAAGAATCTCAGAACTGGGAGCT
GGCAATGGCGGGGTGGTCACCAAGGTCCAACACAGACCATCAGGTCTTATCATGGCCAGGAAGCTGATCCACCTGGAGAT
CAAGCCAGCTATCCGGAACCAGATCATCCGCGAGCTGCAGGTGCTGCACGAGTGCAACTCCCCGTACATCGTGGGCTTTT
ATGGCGCCTTCTACAGCGACGGGGAGATCAGCATCTGCATGGAGCACATGGATGGCGGCTCCTTGGACCAGGTGCTGAAA
GAAGCCAAGCGGATTCCAGAGGAGATCCTGGGGAAGGTCAGCATCGCGGTGCTCCGGGGCCTGGCCTACCTGCGGGAGAA
GCACCAGATCATGCACCGAGACGTGAAGCCTTCCAACATCCTCGTCAACTCCCGAGGGGAGATCAAGCTGTGTGACTTCG
GGGTGAGCGGGCAGCTCATTGACTCCATGGCCAACTCGTTCGTGGGCACCCGGTCCTACATGTCTCCAGAACGGCTGCAG
GGCACCCACTACTCCGTGCAGTCGGACATCTGGAGCATGGGCCTGTCCCTGGTGGAGCTATCCATCGGGAGGTACCCCAT
TCCCCCGCCGGACGCCAAGGAGCTGGAGGCCATCTTTGGCCGGCCCGTGACGGACGGGGCGGAAGGAGAGCCCCACAGCA
TCTCACCACGGCCCAGACCCCCTGGACGCCCCGTCAGCGGTCACGGGATGGACAGCCGGCCCACCATGGCCATCTTTGAG
CTGCTGGACTACATCGTGAACGAGCCGCCTCCTAAGCTGCCCAGTGGGGTGTTCAGCCCAGACTTCCAGGAGTTTGTAAA
TAAATGCCTCATTAAGAACCCAGCAGAACGAGCGGATCTGAAGATGCTCATGAACCACTCGTTCATCAAGCGGGCCGAGG
TGGAAGAAGTGGACTTTGCGGGCTGGCTGTGCCGAACCCTGCGGCTGAAGCAGCCCAGCACGCCCACGCGCACGGCCGTG
TGA

ENSECAG00000009157
--------------------------------------------------------------------------------
-------------GCGAACCTGGTGGACCTGCAGAAGAAGCTCGAGGAGCTCGAGCTCGACGAGCAGCAG---AAGCGGC
TGGAAGCCTTCCTCACCCAGAAGGCCAAGGTCGGGGAGCTCAAGGACGATGACTTTGAGAGGCTCTCCGAGCTGGGAGCC
GGCAACGGCGGGGTGGTCACCAAAGTCCAGCACAGGCCTTCGGGCCTCATCATGGCCAGGAAGCTGATCCACCTGGAGAT
CAAGCCGGCCATCCGGAACCAGATCATCCGCGAGCTGCAGGTACTTCACGAGTGCAACTCGCCCTACATCGTCGGCTTCT
ACGGGGCCTTCTACAGCGACGGCGAGATCAGCATCTGCATGGAGCACATGGACGGCGGCTCTCTGGACCAGGTGTTGAAA
GAAGCCAAGAGAATCCCCGAGGAGATTCTGGGGAAGGTCAGCATCGCGGTGCTCCGGGGCCTGGCGTATCTCCGGGAGAA
GCACCAGATCATGCACCGAGACGTGAAGCCGTCCAACATCCTGGTCAACTCCAGAGGGGAGATCAAGCTGTGCGATTTCG
GGGTGAGCGGGCAGCTCATCGACTCCATGGCCAACTCCTTCGTGGGGACTCGCTCGTACATGTCCCCCGAGCGCCTGCAG
GGCACGCACTACTCCGTGCAGTCGGACATCTGGAGCATGGGCCTGTCCCTGGTGGAGCTGTCCGTCGGCAGGTACCCCAT
CCCGCCGCCCGACGCCAAGGAGCTCGAGGCCATCTTCGGCCGGCCCGTGGTTGACGGGGCGGAAGACGAGCCCCCCAGCA
CCTCGCCGCGGCCCAGGCCCCCCGGACGCGCCATCAGTGGTCACGGGATGGACAGCCGGCCGGCCATGGCCATCTTCGAA
TTGCTGGACTATATTGTGAATGAGCCTCCTCACAAGCTGCCCCACGGCGCCTTCACGCAGGACTTCCAGGAGTTTGTAAA
TAAATGCCTCATTAAGAACCCAGCCGAGCGAGCGGATCTGAAGATGCTCATGAACCACGCCTTCATCAAGCGGTCGGAGG
TGGAAGAAGTGGATTTTGCCGGCTGGCTGTGTAAGACGCTGCGGCTGAACCAGCCCAGCACGCCCACGCGCACGGCCGTG
TGA

ENSG00000126934
ATGCTGGCCCGGAGGAAGCCGGTGCTGCCGGCGCTCACCATCAACCCTACCATCGCCGAGGGCCCATCCCCTACCAGCGA
GGGCGCCTCCGAGGCAAACCTGGTGGACCTGCAGAAGAAGCTGGAGGAGCTGGAACTTGACGAGCAGCAGAAGAAGCGGC
TGGAAGCCTTTCTCACCCAGAAAGCCAAGGTCGGCGAACTCAAAGACGATGACTTCGAAAGGATCTCAGAGCTGGGCGCG
GGCAACGGCGGGGTGGTCACCAAAGTCCAGCACAGACCCTCGGGCCTCATCATGGCCAGGAAGCTGATCCACCTTGAGAT
CAAGCCGGCCATCCGGAACCAGATCATCCGCGAGCTGCAGGTCCTGCACGAATGCAACTCGCCGTACATCGTGGGCTTCT
ACGGGGCCTTCTACAGTGACGGGGAGATCAGCATTTGCATGGAACACATGGACGGCGGCTCCCTGGACCAGGTGCTGAAA
GAGGCCAAGAGGATTCCCGAGGAGATCCTGGGGAAAGTCAGCATCGCGGTTCTCCGGGGCTTGGCGTACCTCCGAGAGAA
GCACCAGATCATGCACCGAGATGTGAAGCCCTCCAACATCCTCGTGAACTCTAGAGGGGAGATCAAGCTGTGTGACTTCG
GGGTGAGCGGCCAGCTCATCGACTCCATGGCCAACTCCTTCGTGGGCACGCGCTCCTACATGGCTCCGGAGCGGTTGCAG
GGCACACATTACTCGGTGCAGTCGGACATCTGGAGCATGGGCCTGTCCCTGGTGGAGCTGGCCGTCGGAAGGTACCCCAT
CCCCCCGCCCGACGCCAAAGAGCTGGAGGCCATCTTTGGCCGGCCCGTGGTCGACGGGGAAGAAGGAGAGCCTCACAGCA
TCTCGCCTCGGCCGAGGCCCCCCGGGCGCCCCGTCAGCGGTCACGGGATGGATAGCCGGCCTGCCATGGCCATCTTTGAA
CTCCTGGACTATATTGTGAACGAGCCACCTCCTAAGCTGCCCAACGGTGTGTTCACCCCCGACTTCCAGGAGTTTGTCAA
TAAATGCCTCATCAAGAACCCAGCGGAGCGGGCGGACCTGAAGATGCTCACAAACCACACCTTCATCAAGCGGTCCGAGG
TGGAAGAAGTGGATTTTGCCGGCTGGTTGTGTAAAACCCTGCGGCTGAACCAGCCCGGCACACCCACGCGCACCGCCGTG
TGA

ENSLAFG00000015636
GTGCTAGCCTTGGAACAGGACCGGCGACCGGGGCCCGGGTTGCATCATCTCTCGGCTGCCCACCCGTCACCTGCTAACCC
TGGTCTCCACAGAGCAAACTTGGTGGACCTCCAGAAGAAGCTAGAGGAGCTAGAGCTAGACGAGCAGCAAAAGAAGCGTC
TGGAAGCCTTCCTCACCCAGAAGGCCAAGGTCGGCGAACTCAAGGACGATGACTTCGAGAGGATTTCGGAGCTGGGAGCT
GGGAATGGCGGGGTGGTCACCAAAGTGCAGCACAGACCCTCAGGCCTCATCATGGCGAGGAAGCTGATTCACCTGGAGAT
CAAGCCGGCCATCCGGAACCAGATCATCCGGGAGCTGCAGGTCCTGCACGAGTGTAACTCCCCGTACATCGTGGGCTTCT
ACGGGGCCTTCTACAGCGACGGGGAGATCAGCATCTGCATGGAGCACATGGACGGAGGCTCCCTGGACCAGGTGCTGAAA
GAAGCCAAGAGGATTCCAGAAGAGATCCTGGGGAAGGTCAGCATTGCGGTTCTCCGGGGCTTGGCGTACCTCCGGGAAAA
GCACCAGATCATGCACCGAGATGTGAAGCCCTCCAACATCCTGGTCAACTCCAGAGGGGAGATCAAGCTGTGTGACTTCG
GGGTGAGCGGGCAGCTCATCGACTCGATGGCCAACTCCTTTGTGGGGACACGCTCCTACATGTCGCCGGAGCGCTTGCAA
GGCACCCACTACTCCGTGCAGTCGGACATCTGGAGCATGGGCTTGTCGCTGGTGGAGCTGTCCGTTGGGAGGTACCCCAT
CCCCCCGCCGGATGCCAAGGAGCTGGAGGCCATCTTCGGCCGGCCGGTGGTCGACGGGGCCGAGGGAGAGCCCCACAGCG
TCTCGCCACGGCCACGGCCCCCTGGACGCCCCATCAGTGGTCACGGGATGGACAGCCGGCCCGCCATGGCCATCTTTGAA
CTGCTGGACTACATTGTGAATGAGCCTCCCCCGAAGCTGCCCAGCGGCGTCTTCACCCAGGACTTCCAGGAGTTTGTAAA
TAAATGCCTGATCAAGAACCCGGCAGAGCGTGCTGACCTGAAGATGCTGATGAACCACACCTTCATCAAACGCTCCGAGG
TGGAAGAAGTGGATTTTGCAGGCTGGTTGTGTAAAACCCTGAGGTTGAACCAGCCCAGCACGCCCACGCGAACCACCGTG
TGA

ENSMODG00000000809
ATGCTGGCCAAGAGGAAGCCGGTGCTGCCGGCGCTCAACATCACCCCCACCAACGCCGAGGGCCCGTCCCCGACCAGCGA
GGGCGCGTCCGAGGCAAACTTGGCAGACCTGCAGAAAAAATTAGAGGAACTAGAACTTGATGAGCAGCAAAAGAAGCGAC
TGGAAGCTTTCCTTACCCAAAAGGCAAAGGTGGGGGAACTGAAGGATGATGACTTTGAAAGAATCTCTGAACTGGGAGCT
GGCAATGGTGGGGTGGTCACCAAAGTGCAACATAGGCCCTCAGGCCTCATCATGGCCCGAAAGTTGATTCACCTAGAGAT
CAAACCAGCAATCCGGAACCAGATTATCCGTGAACTCCAGGTCCTACATGAATGCAACTCTCCATACATTGTGGGTTTCT
ATGGTGCCTTTTATAGTGATGGAGAGATTAGCATCTGCATGGAGCACATGGATGGCGGTTCTCTGGATCAAGTATTGAAA
GAGGCCAAGAGAATTCCTGAAGAAATCTTGGGGAAGGTTAGCATTGCGGTTCTTCGGGGTTTGGCTTATCTAAGAGAGAA
ACACCAGATTATGCACAGAGATGTGAAACCTTCCAACATCTTGGTCAATACTCGGGGAGAGATCAAGCTCTGTGATTTTG
GGGTGAGCGGGCAACTCATCGACTCTATGGCAAATTCCTTTGTAGGAACCCGATCCTACATGTCTCCGGAGCGATTGCAA
GGCACCCACTACTCAGTCCAGTCAGATATCTGGAGCATGGGCTTGTCCCTAGTAGAGCTGTCCATTGGAAGGTACCCGAT
TCCCCCACCAGACTCCAAGGAACTAGAAGCGATATTTGGTCGGCCCATGGTCGATGGGGCAGAGGGAGAACCTCACAGCA
TCTCACCACGGCCACGACCCCCAGGACGTCCCATCAGTGGTCATGGGATAGACAGTCGGCCTGCCATGGCCATCTTTGAG
CTATTGGATTATATTGTTAATGAGCCTCCACCTAAGCTGCCGAATGGTGTTTTCACACAAGATTTCCAGGAGTTTGTAAA
TAAATGCTTAATTAAAAACCCAGCCGAGAGGGCCGATCTGAAGATGCTGATGAATCACACTTTTATCAAACGGTCAGAAG
TGGAAGAAGTGGATTTTGCAGGCTGGTTATGTAAAACTCTGAGGTTAAACCAGCCCAGCACTCCCACACACACTGCCATG
TGA

ENSPANG00000008882
ATGCTGGCCCGGAGGAAGCCGGTGCTGCCGGCGCTCACCATCAACCCTACCATCGCCGAGGGCCCGTCCCCTACCAGCGA
GGGCGCCTCCGAGGCAAACCTGGTGGACCTGCAGAAGAAGCTGGAGGAGCTGGAACTTGACGAGCAGCAGAAGAAGCGTC
TGGAAGCCTTTCTCACCCAGAAAGCCAAGGTCGGCGAACTCAAAGACGATGACTTCGAAAGGATCTCAGAGCTGGGCGCG
GGCAATGGCGGGGTGGTCACCAAAGTCCAGCACAGACCCTCGGGCCTCATCATGGCCAGGAAGCTGATCCACCTTGAGAT
CAAGCCGGCCATCCGGAACCAGATCATCCGCGAGCTGCAGGTCCTGCATGAGTGCAACTCGCCGTACATCGTGGGCTTCT
ACGGGGCCTTCTACAGCGACGGGGAGATCAGCATCTGCATGGAGCACATGGATGGCGGCTCCCTGGACCAGGTGCTGAAG
GAGGCCAAGAGGATCCCCGAGGAGATCCTGGGGAAAGTCAGCATTGCGGTTCTCCGGGGCTTGGCGTATCTCCGAGAGAA
GCACCAGATCATGCACCGAGATGTGAAGCCCTCCAACATCCTTGTGAACTCCAGAGGGGAGATCAAGCTGTGTGACTTCG
GGGTGAGCGGCCAGCTCATCGACTCCATGGCCAACTCCTTCGTGGGCACACGCTCCTACATGGCTCCGGAGCGGTTGCAG
GGCACACATTACTCGGTGCAGTCGGACGTCTGGAGCATGGGCCTGTCCCTGGTGGAGCTGGCCATCGGAAGGTACCCCAT
CCCCCCGCCCGACGCCAAGGAGCTGGAGGCCATCTTTGGCCGGCCAGTGGTCGACGGGGAAGAAGGAGAGCCTCACAGCA
TCTCGCCTCGGCCGAGACCCCCCGGGCGCCCCATCAGCGGTACGGTGCCCTGGGGCCACCAACTAACTGCCCTA---TCT
TGTCTCCCCTACTGCTTC------------CCGGTCCTGCCTCTTGGAACC-----------------------------
-CCCAGCCTCATCAAGAACCCAGCGGAGCGGGCGGACCTGAAGATGCTCACGAACCACACCTTCATCAAGCGGTCCGAGG
TGGAAGAGGTGGATTTTGCCGGGTGGTTGTGTAAAACCCTGCGACTGAACCAGCCCGGCACACCCACGCGCACCGCCGTG
TGA

ENSRNOG00000020005
ATGCTGGCCCGGAGGAAGCCGGTGTTACCGGCGCTCACCATCAACCCTACCATCGCTGAGGGCCCGTCCCCCACCAGCGA
GGGCGCCTCCGAGGCACACCTGGTGGACCTCCAGAAGAAGTTGGAAGAGCTGGACCTGGATGAACAGCAGAGGAAGCGGC
TGGAGGCCTTCCTTACCCAGAAGGCCAAGGTTGGTGAGCTCAAGGACGACGACTTTGAGAGAATCTCAGAACTGGGTGCA
GGCAATGGCGGCGTGGTCACAAAGGCCCGGCATAGGCCCTCTGGCCTCATCATGGCCAGAAAGCTGATCCACCTGGAGAT
CAAGCCAGCTGTCCGCAACCAGATCATCCGGGAGCTGCAGGTGCTGCATGAGTGCAACTCACCGTACATCGTGGGCTTTT
ATGGGGCCTTCTACAGCGACGGCGAGATCAGCATCTGCATGGAGCACATGGACGGTGGCTCACTGGACCAGGTACTGAAG
GAGGCCAAGCGCATTCCCGAGGACATCTTAGGGAAGGTCAGCATTGCGGTGCTCCGGGGCCTGGCGTACCTCCGCGAGAA
GCACCAGATCATGCATAGAGATGTGAAGCCCTCCAACATTCTGGTGAACTCTCGTGGAGAGATTAAGCTGTGCGACTTCG
GAGTGAGCGGCCAGTTGATTGACTCCATGGCCAACTCATTTGTAGGGACACGCTCCTACATGTCCCCAGAACGGCTGCAG
GGCACCCACTACTCTGTGCAGTCGGACATCTGGAGCATGGGGCTGTCGCTGGTGGAGCTGGCCATCGGGAGGTACCCCAT
CCCCCCACCTGATGCCAAGGAACTAGAGGCCAGCTTTGGCCGGCCTGTGGTGGACGGGGCAGATGGAGAGCCCCATAGTG
TCTCACCGCGGCCCCGGCCCCCTGGACGCCCCATCAGTGGTCATGGGATGGACAGCCGACCAGCCATGGCCATCTTTGAG
CTGCTGGACTACATAGTGAATGAGCCACCTCCCAAGCTGCCCAGTGGTGTGTTCAGCTCAGACTTCCAGGAGTTTGTGAA
TAAATGTCTCATTAAGAACCCAGCAGAGCGTGCAGACCTCAAGCTGCTGACGAACCATGCCTTCATCAAACGCTCTGAGG
GGGAGGACGTGGACTTCGCTGGCTGGCTATGCAGAACCCTGCGGCTGAAGCAGCCCAGCACACCCACGCGTACTGCAGTG
TGA

ENSRROG00000031471
ATGGGATCGAGGCAGCATCCTCAGTTCCCGGGG------ATCCGCCCTTCATTGGTAGCTAACCCCTGCCCTGGG-----
-GGTCTCTGCAGGGCAAACCTGGTGGACCTGCAGAAGAAGCTGGAGGAGCTGGAACTGGACGAGCAGCAGAAGAAGCGTC
TGGAAGCCTTTCTGACCCAGAAAGCCAAGGTCGGCGAACTCAAAGACGATGACTTCGAAAGGATCTCAGAGCTGGGCGCG
GGCAACGGCGGGGTGGTCACCAAAGTCCAGCACAGACCCTCGGGCCTCATCATGGCCAGGAAGCTGATCCACCTTGAGAT
CAAGCCGGCCATCCGGAACCAGATCATCCGCGAGCTGCAGGTCCTGCATGAGTGCAACTCGCCATACATCGTGGGCTTCT
ACGGGGCCTTCTACAGCGACGGGGAGATCAGCATCTGCATGGAGCACATGGATGGCGGCTCCCTGGACCAGGTGCTGAAG
GAGGCCAAGAGGATCCCCGAGGAGATCCTGGGGAAAGTCAGCATCGCGGTTCTCCGGGGCTTGGCGTATCTCCGAGAGAA
GCACCAGATCATGCACCGAGATGTGAAGCCCTCCAACATCCTTGTGAACTCCAGAGGGGAGATCAAGCTGTGTGACTTCG
GGGTGAGCGGCCAGCTCATCGACTCCATGGCCAACTCCTTCGTGGGCACACGCTCCTACATGGCTCCGGAGCGATTGCAG
GGCACACATTACTCGGTGCAGTCGGACATCTGGAGCATGGGCCTGTCCCTGGTGGAGCTGGCCATCGGAAGGTACCCCAT
CCCCCCGCCCGACGCCAAGGAGCTGGAGGCCATCTTTGGCCGGCCAGTGGTCGACGGGGAAGAAGGAGAGCCTCGCAGCA
TCTCGCCTCGGCCGAGACCCCCCGGGCGCCCCATCAGCGGTCACGGGATGGACAGCCGGCCCGCCATGGCCATCTTCGAA
TTGCTGGACTATATTGTGAATGAGCCGCCTCCCAAGCTGCCCAACGGTGTGTTCACCCCCGACTTCCAGGAGTTTGTCAA
TAAATGCCTCATCAAGAACCCAGCAGAGCGGGCGGACCTGAAGATGCTCACGAACCACACCTTCATCAAGCGGTCCGAGG
TGGAAGAAGTGGATTTTGCTGGGTGGTTGTGTAAAACCCTGCGACTGAACCAGCCCGGCACACCCACGCGTACCGCCATG
TGA

ENSSSCG00000027127
ATGCTGGCCCGGAGGAAGCCGGTGCTGCCGGCGCTCACCATCAACCCCGCCATCGCCGAGGGCCCGTCCCCCACCAGCGA
GGGCGCCTCCGAAGCAAACTTGGTGGATCTCCAGAAGAAGCTAGAGGAGCTAGAACTCGACGAGCAGCAGAAGAAGCGGC
TAGAAGCCTTTCTCACCCAGAAGGCCAAGGTCGGGGAGCTCAAGGACGATGACTTTGAAAGGATCTCGGAGCTGGGAGCC
GGGAACGGCGGAGTGGTCACCAAGGTCCAGCACAGACCCTCAGGCCTCATCATGGCAAGAAAGCTGATCCACTTGGAGAT
CAAGCCGGCCATCCGGAACCAGATCATCCGCGAGCTGCAGGTACTGCACGAGTGTAACTCCCCCTACATCGTGGGCTTCT
ATGGGGCCTTCTACAGTGACGGGGAGATCAGTATCTGCATGGAGCACATGGATGGCGGCTCCCTGGACCAGGTGTTGAAA
GAAGCCAAGAGAATTCCTGAGGAAATCCTGGGGAAGGTCAGCATCGCGGTTCTGCGGGGCCTGGCATATCTCCGGGAAAA
GCACCAGATCATGCACCGAGATGTGAAGCCATCCAACATCCTTGTCAACTCCCGAGGGGAGATCAAGTTGTGCGACTTTG
GGGTGAGCGGGCAGCTCATCGATTCCATGGCCAACTCCTTCGTGGGAACACGGTCCTACATGTCTCCGGAGCGGCTGCAG
GGCACTCACTACTCGGTGCAGTCGGACATCTGGAGCATGGGCCTGTCCCTGGTGGAGCTGTCCATCGGAAGGTACCCCAT
CCCCCCACCGGATGCCAAGGAGCTGGAGGCCATATTTGGCCGGCCCATGGTTGATGGAGGGGACGGAGAGCCTCACAGCA
TCTCGCCACGGCCGAGACCCCCTGGACGCCCCATCAGCGGTCACGGGATGGACAGCCGGCCGGCCATGGCTATCTTCGAG
CTGCTGGACTACATCGTGAATGAGCCACCTCCCAAGCTGCCCAATGGCGTCTTCACCCAGGACTTCCAGGAGTTTGTAAA
TAAATGCCTAATTAAGAACCCAGCAGAGCGAGCGGATCTGAAGATGCTCATGAACCACACCTTCATCAAACGGTCCGAGG
TGGAAGAAGTGGATTTTGCCGGCTGGTTGTGTAAAACGCTGCGGCTGAACCAGCCCAGCACGCCCACGCGCACCGCCGTG
TGA

ENSSTOG00000002366
ATGCTCGCAAAGAGACGGACGGCCACTCCAAGCCTCACCCTGCGGGGCTCTGATGCCGCTTCTCCTGGTCCAGCTGAGAA
GGGGGCCCTGGAGGCAAACCTGGTGGACCTGCAGAAGAAGCTGGAGGAGCTGGAGCTAGACGAGCAGCAAAAGAAGCGGT
TAGAGGCCTTCCTGACTCAGAAGGCCAAGGTTGGTGAGCTCAAGGACGACGACTTTGAAAGGATCTCAGAGCTGGGAGCT
GGCAATGGCGGGGTGGTCACGAAGGTCCAGCACAGGCCATCGGGCCTCATCATGGCCAGAAAGCTGATCCACCTGGAGAT
CAAGCCAGCCATCCGGAACCAGATCATCCGCGAGCTTCAGGTCCTACATGAGTGCAACTCCCCGTACATCGTGGGCTTCT
ACGGCGCCTTCTACAGCGACGGGGAGATCAGCATCTGCATGGAGCACATGGACGGGGGCTCCCTGGACCAGGTGTTGAAG
GAGGCCAAGAGGATCCCCGAGGAGATCTTGGGGAAGGTCAGCATTGCGGTTCTCCGGGGCCTGGCATACCTTCGAGAAAA
GCATCAGATCATGCACCGAGATGTGAAACCCTCCAACATCCTGGTCAACTCCAGAGGGGAGATCAAGCTGTGCGACTTCG
GGGTGAGCGGGCAGCTCATCGATTCCATGGCCAACTCCTTCGTGGGAACGCGGTCCTACATGTCTCCAGAGCGATTGCAA
GGCACACACTATTCGGTGCAGTCGGACATCTGGAGCATGGGCCTGTCCTTGGTGGAGCTGTCTATCGGGAGGTACCCCAT
TCCCCCACCCGATGCCAAGGAGCTGGAGGCCATCTTCGGCAGGCCCGTGGGCAACGGTGCAGAAGGAGAGCCCCACAGCA
CCTCACCCCGGCCGAGACCCCCTGGGCGCCCCATCAGCGGTCACGGGATGGACAGCCGGCCAGCCATGGCCATCTTCGAG
CTGCTGGACTACATTGTGAATGAGCCACCTCCCAAGCTACCCAGTGGCGTGTTCAGCCCACACTTCCAGGAATTCGTGCA
TAAATGCCTCATTAAGAACCCAGCAGAACGAGCAGATCTGAAGATGCTCATGGGCCATGCCTTCATCAAGCGCTCAGAGG
CTGAAGAGGTGGACTTCGCCGGCTGGCTGTGCAGGACCCTGCGGCTCAACCAGCCCAGCACACCCACGCGCACCGCTGTG
TGA
