ENSP00000262948
ENSAMEP00000002349
ENSBTAP00000011377
ENSCJAP00000027831
ENSCPOP00000014257
ENSDNOP00000010507
ENSDORP00000001187
ENSECAP00000007767
ENSFCAP00000029744
ENSFDAP00000003251
ENSSTOP00000002113
ENSLAFP00000013107
ENSMMUP00000025705
ENSMAUP00000010978
ENSMODP00000000964
ENSMUSP00000121111
ENSMLUP00000007914
ENSNGAP00000025240
ENSOANP00000015102
ENSOGAP00000001479
ENSPTRP00000017496
ENSPANP00000039137
ENSPPYP00000011850
ENSPVAP00000002530
ENSRNOP00000027272
ENSRROP00000014534
ENSSBOP00000035042
ENSSSCP00000019233
ENSTTRP00000006413
